10 10
==========
=X =*!   =
=  =*    =
=   *  **=
=       X=
=X  ==== =
=   =****=
=#= =*!  =
=@= =*X  =
==========
X 1 1 4 8
X 5 1 8 6
K 1 8
M 2 2
W 5 3
T 8 3